########################################################################################################################################################################################################################################################################################################################################################################
########################################################################################################################################################################################################################################################################################################################################################################
########################################################################################################################################################################################################################################################################################################################################################################
########################################################################################################################################################################################################################################################################################################################################################################
########################################################################################################################################################################################################################################################################################################################################################################
##########.................................................................................................................................................................................................................................................................#############################################################################################
##########.................................................................................................................................................................................................................................................................#############################################################################################
##########.................................................................................................................................................................................................................................................................#############################################################################################
##########.................................................................................................................................................................................................................................................................#############################################################################################
##########.................................................................................................................................................................................................................................................................#############################################################################################
##########..........................................................................................................................############...........................................................................................................................#############################################################################################
##########....@..........................................................................................##########.....#########..........................................................................................................................................#############################################################################################
##########..................................................................................##########.................................................#########...........................................................................................................#############################################################################################
##########.............................................................................##...................................................................................................................................................................................................############################################################################
##########..................................................................########............................................................................................................................................................................................................########################################################################
##########................................................................##.......................................................................................................................................................................................................................#####################################################################
##########.............................................................................................................................................................................................................................................................................................#################################################################
######################################...#####################....###############################.....................................................######################################################################################################################...............................#############################################################
######################################...#####################....###############################.....................................................##########################################################################################################################...............................#########################################################
######################################...#####################....###############################.....................................................##############################################################################################################################...............................#####################################################
######################################...#####################....###############################.....................................................##################################################################################################################################..............................##################################################
######################################...#####################....###############################.....................................................######################################################################################################################################.......................................................................#####
######################################...#####################....###############################.....................................................##########################################################################################################################################...................................................................#####
######################################...#####################....###############################.....................................................##########################################################################################################################################...................................................................#####
######################################...#####################....###############################.....................................................##########################################################################################################################################...................................................................#####
######################################...#####################....###############################.....................................................##########################################################################################################################################...................................................................#####
######################################...#####################....###############################.....................................................##################################################################################################################################################################################...........................#####
######################################...#####################....###############################.....................................................##################################################################################################################################################################################...........................#####
######################################...#####################....###############################.....................................................##################################################################################################################################################################################...........................#####
######################################...#####################....###############################.....................................................##################################################################################################################################################################################...........................#####
######################################...#####################....###############################.....................................................##################################################################################################################################################################################...........................#####
######################################...#####################....###############################.....................................................##################################################################################################################################################################################...........................#####
######################################...#####################....###############################.....................................................##################################################################################################################################################################################...........................#####
######################################...#####################....###############################.....................................................##################################################################################################################################################################################...........................#####
######################################...#####################....###############################.....................................................##################################################################################################################################################################################...........................#####
######################################...#####################....###############################.....................................................##################################################################################################################################################################################...........................#####
######################################...#####################....###############################.....................................................##################################################################################################################################################################################...........................#####